4        0        0        1        -4        -4        -4        1        0        0        -4        1        -4        5        5
0        2        1        -4        2        2        0        5        -4        2        1        -4        2        2        0
0        1        2        -4        1        -4        -4        1        -4        -4        1        0        2        2        -4
-4        -4        -4        -4        4        -4        1        2        1        -4        0        -4        -4        0        -4
1        -4        1        -4        1        -4        0        -4        -4        -4        1        -4        1        5        1
-4        0        2        -4        2        5        3        3        3        0        1        -4        2        -4        -4
1        -4        -4        0        -4        -4        2        3        2        -4        0        -4        -4        -4        1
0        5        2        -4        1        -4        2        3        2        -4        1        0        2        -4        0
1        0        1        -4        1        -4        -4        -4        -4        0        1        -4        2        -4        2
0        -4        -4        0        -4        0        2        1        2        0        0        -4        -4        0        0
-4        1        2        0        1        -4        -4        2        -4        -4        2        0        1        1        -4
0        2        1        -4        1        1        0        -4        -4        1        2        0        1        1        0
5        0        -4        2        5        -4        -4        2        -4        -4        0        2        -4        5        0